##############
# #          #
#@$   #      #
# #####$@    #
# #          #
#.#.         #
############## 
