##############
# #          #
#@$ #        #
# ###  $@    #
# #          #
#.#.         #
############## 
