##############
#        ##  #
# # # # #    #
# # # # ###  #
#x o o o /// #
# # # # #### #
# # # # #  # #
#        #   #
##############
