##########
##      ##
## ## # ##
##  # # ##
###oo    #
#   ###o##
# # ##  /#
# # ## x/#
#       /#
##########
