###################
#  ################
#                 #
# ##############  #
# #        ##x # ##
# #      #   o # ##
# #        ##  # ##
# #         #o # ##
# #         #  # ##
# #        ##o # ##
#/#      #     # ##
#/#        ##    ##
#/#############  ##
################### 
