##############
#        #####
# # # # ######
# # # # ######
#  o o    OX/#
# # # # ######
# # # # ######
#        #####
##############
