#########
#       #
#       #
## o# ###
##  # ###
## ##   #
#    x /#
#  #    #
#  #    #
######### 
