###################
#  ################
#                 #
# ##############  #
# #        ##x # ##
# #      #   o # ##
# #        ##  # ##
# #         #o # ##
# #         #  # ##
# #        ##o # ##
# #      #     # ##
#/#/       ##    ##
#/#############  ##
###################
