#########
#       #
#       #
## o    #
##      #
##    x/#
#       #
#       #
#       #
######### 
