##########
##      ##
## ## # ##
##  # # ##
###o     #
#   ###o##
# # ##  /#
# # ## x##
#       /#
########## 
