#########
#       #
#       #
## o# ###
##  # ###
## ##   #
#  o x /#
#  #   /#
#  #    #
######### 
