##################
###############  #
#                #
#  ############# #
##            ## ##
##           o#/  #
##          x   # #
##           o#/  #
##            ## ##
#  ############# #
#                #
###############  #
##################
