     ####
######  #
#       #
#  ... .#
##$######
# $  #
#   $###
##  $  #
 ## @  #
  ######