 #####
##. .##
# * * #
#  #  #
# $ $ #
## @ ##
 #####