#####
#   #
# @ #
# $$###
##. . #
 #    #
 ######