####
#  ####
# $   #
# .#  #
# $# ##
# .  #
#### #
   # #
 ### ###
 #  $  #
## #$# ##
# $ @ $ #
# ..#.. #
###   ###
  #####