#####   ####
#   ##### .#
#       $  ########
###  #### .$    @ #
  #  #  #  ####   #
  ####  ####  #####