 ####
 #  #######
 #$ @#   .#
## #$$   .#
#  $  ##..#
#   # #####
###   #
  #####