######
#... #
#  $ #
# #$##
#  $ #
#  @ #
######