   #####
   # @ #
  ##   ##
###.$$$.###
#  $...$  #
#  $.#.$  #
#  $...$  #
###.$$$.###
  ##   ##
   #   #
   #####