#####  #####
#   ####.. #
# $$$      #
#   $#  .. #
### @#  ## #
  #  ##    #
  ##########