 #### ####
##  ###  ##
#   # #   #
#  *. .*  #
###$   $###
 #   @   #
###$   $###
#  *. .*  #
#   # #   #
##  ###  ##
 #### ####