########
#      #
# $*** #
# *  * #
# *  * #
# ***. #
#     @#
########