      ####
#######  #
# $      ##
# $#####  #
#  @#  #  #
## ##..   #
#  # ..####
# $  ###
# $###
#  #
####