   #####
  ##   #
###  # #
#    . #
#  ## #####
#  . . #  ##
#  # @ $   ###
#####. #  $  #
    ####  $  #
       ## $ ##
        #  ##
        #  #
        ####