#############
#           #
# x   ####  #
#     # G   #
#     #     #
#############
