###################
#                 #
# @  ############ #
#      #          #
#  #####  #########
#  #   #          #
#  #   #          #
#      #    ####  #
########   ##     #
#    . #    # #####
#   ####    #     #
#           #  .  #
###################
