#############
#           #
# @   ####  #
#     # .   #
#     #     #
#############
