######
#    #
#   .#
# @  #
######
