######
#    #
#   G#
# x  #
######
